pizza|pica|pice|pizze
pljeskavaica|pljeska
coca|cola|koka|kola
bruskete|brusketi
spagete|spageti
palacinka|palacinke
snicla|snicle
kobasica|kobaja|wurst|vurst
akva|aqua
bolonjez|bolonjeze|bolognese
cetiri|quattro|quatro|kvatro|qvatro
cockta|kokta
juice|djus
hamburger|burger
kalcona|kalcone|calzone
kisela|mineralna
nekst|next
biftek|steak|stek
carpaccio|carpacio|karpaco
cevapi|cevap|cevapcici
riba|brancin|pastrmka|losos|saran|girice|orada|skarpina|oslic|smudj|som
espresso|espreso|kafa
indeks|index
krilca|wings
vegeterijana|vegeterijano
pancerota|pancerote|panceroti
karbonara|karbonare
raznjic|raznjici
ustipak|ustipci
bekendeks|bacon|eggs